V,V,V,V,V,V,V,V,V,V
V,V,V,V,V,V,V,V,V,V
V,V,V,V,V,M,M,M,M,M
V,V,V,V,V,M,V,V,V,M
V,V,V,V,V,M,V,C,V,M
V,V,V,V,V,M,A,D,V,M
V,V,V,V,V,M,M,M,M,M
