V,M,M,M,M,M,M,M,M,M
V,M,V,V,V,C,V,V,D,M
V,M,V,V,V,V,V,V,V,M
V,M,V,V,V,V,V,V,V,M
V,M,V,A,V,V,V,D,V,M
V,M,V,V,V,V,V,V,V,M
V,M,M,M,M,M,V,V,V,M
V,V,V,V,V,M,V,C,V,M
V,V,V,V,V,M,V,V,V,M
V,V,V,V,V,M,M,M,M,M
V,V,V,V,V,V,V,M,V,V
