V,V,V,V,V,V,V,V,V,V,V,V,V,M,M,M,M,M,M,M,M,M,M,M,M
V,V,M,M,M,M,M,M,M,M,M,M,M,M,V,V,V,V,V,V,V,V,V,D,M
V,V,M,A,V,V,V,V,V,V,V,V,V,V,V,V,V,V,V,V,V,V,V,V,M
V,V,M,V,V,V,V,V,V,V,V,V,V,V,V,V,V,V,V,V,V,V,V,V,M
V,V,M,V,V,V,V,V,V,V,V,D,V,V,V,V,V,V,V,V,V,V,V,V,M
V,V,M,V,C,V,V,V,V,V,V,V,V,V,V,V,V,V,V,V,V,V,V,V,M
V,V,M,V,V,V,V,V,V,V,V,V,V,V,V,V,V,V,V,V,V,V,V,C,M
V,V,M,V,V,V,V,V,V,V,V,V,V,V,V,V,V,V,V,V,V,V,V,V,M
V,V,M,M,M,M,M,M,M,M,M,M,M,M,M,M,M,M,M,M,M,M,M,M,M
