10
M,M,M,M,M,M,M
M,A,V,V,V,V,M
M,V,C,V,V,V,M
M,V,V,V,V,D,M
M,M,M,M,M,M,M
