V,V,V,V,V,V,V,V,V,V,V,V,V,V,M
M,M,M,M,M,M,M,M,M,M,M,M,M,M,M
M,A,V,V,V,V,V,V,V,V,V,V,V,M,M
M,V,V,V,D,V,V,V,V,D,V,V,V,M,M
M,V,V,V,V,V,V,V,V,V,V,V,V,M,M
M,V,V,V,V,V,V,V,V,V,M,M,M,M,M
M,V,V,V,C,V,V,C,V,V,M,V,V,V,M
M,V,V,V,V,V,V,V,V,V,V,V,M,V,M
M,V,V,V,V,V,V,V,V,V,V,V,V,V,M
M,V,V,V,V,V,V,V,V,V,V,V,V,V,M
M,V,V,V,V,V,V,V,V,V,V,V,V,V,M
M,M,M,M,M,M,M,M,M,M,M,M,M,M,M