V,V,V,V,V,V,V,V,V,V,V,V,V,V,V,V
M,M,M,M,M,M,M,M,M,M,M,M,M,M,M,V
M,V,V,V,V,V,V,V,V,V,V,V,V,V,M,V
M,V,A,V,V,V,V,V,V,V,V,C,V,V,M,V
M,V,M,V,V,V,M,M,M,V,V,V,V,V,M,V
M,V,M,V,V,V,M,V,M,V,V,V,V,V,M,V
M,V,M,V,V,V,M,V,M,V,V,V,V,V,M,V
M,V,M,M,M,V,M,V,M,M,V,V,V,V,M,V
M,V,V,V,V,V,V,V,V,V,V,V,D,V,V,M
M,M,M,M,M,M,M,M,M,M,M,M,M,M,M,V
