V,V,V,V,V,V,V,V,V,V,V,V,V,V,V
V,V,M,M,V,V,V,V,D,V,V,V,V,M,M
V,V,V,M,V,V,V,V,V,V,V,V,V,M,V
V,V,V,M,V,V,V,V,V,V,V,V,V,M,V
V,V,V,M,V,V,V,V,C,V,V,V,V,M,V
V,V,V,M,V,V,V,V,V,V,V,V,V,M,V
V,V,V,M,V,V,V,V,V,V,V,V,V,M,V
V,V,V,M,V,V,V,V,A,V,V,V,V,M,V
V,V,V,M,M,M,M,M,M,M,M,M,M,M,V
