MMMMMMM,
MAVVVVM,
MVCVVVM,
MVVVVDM,
MMMMMMM,
