VVVVVVVVVVVVVVVV
MMMMMMMMMMMMMMMV
MVVVVVVVVVVVVVMV
MVVVMVVVMVVVVVMV
MVVVMVVVMVVVVVMV
MAVVMVCVMVVVVVMV
MVVVMVVVMVVVVVMV
MVVVMVVVVVVVDVMV
MVVVVVVVVVVVVVVM
MMMMMMMMMMMMMMMV
