V,V,V,V,V,V
M,M,M,M,M,M
M,V,A,V,V,M
M,V,V,V,V,M
M,V,V,V,V,M
M,V,V,V,V,M
M,V,V,C,V,M
M,V,V,V,V,M
M,V,V,M,M,M
M,V,V,V,V,M
M,V,V,V,V,M
M,V,V,V,V,M
M,V,D,V,V,M
M,M,M,M,M,M
